######  ###
#**..# ##@##
#**..###...#
#**.....OO.#
#**..#.#.O.#
#**###.#.O.#
####.O.#O..#
   #..O#.O.#
   #.O..O..#
   #..##...#
   #########
