          ####
     #### #..#
   ###.@###O.#
  ##......O..#
 ##..O.OO##.##
 #..#O##.....#
 #.#.O.OO.#.###
 #...O.#..#.O.#####
####....#..OO.#...#
####.##.O.........#
#*....###..########
#**.**#.####
#***#*#
#*****#
#######
