   ########
   #...#..#
   #..O...#
 ###.#O...####
 #..O..##O...#
 #..#.@.O.#.O#
 #..#......O.####
 ##.####O##.....#
 #.O#*****#.#...#
 #..O*****.O#.###
##..#*****#...#
#...###.#######
#.OO..#..#
#..#.....#
######...#
     #####
