#########
#.......#
#.......####
##.####.#..#
##.#@##....#
#.OOO.O..OO#
#..#.##.O..#
#..#.##..O.####
####..OOO.O#..#
 #...##...****#
 #.#...#.#**.*#
 #...#.#.##***#
 #####.O..#***#
     ##...#####
      #####
