###############
#**********..*####
#**********OO*#..#
###########O.#...##
#......O..O.....O.#
##.####...#..O.#..#
#......#...##..#.##
#..O#..#.##..###.##
#.O.#O###....###.##
###..O.#..#..###.##
###....O.##.#..#.##
 #.O..#..O..O.O...#
 #..O..O#OOO..#...#
 #..#..O......#####
 #.@##..#..#..#
 ##############
