####
#..##############
#..#...**#******#
#..#.#.#####.***#
##O#....********#
#...##O######..####
#.O.#.....######@.#
##O.#.O...######..#
#..O.#OOO##.......#
#......#....#O#O###
#.####.#OOOOO....#
#.#....O.....#...#
#.#...##........###
#.######O######.O.#
#........#    #...#
##########    #####
