       ###########
       #...#.....#
#####  #.....O.O.#
#...#####.O##.#.##
#.O.##...#.##.O..#
#.O..@OO.#.##OOO.#
##.###...#.##....#
##.#...###.#####O#
##.#.....O..#****#
#..###.##.O.#****##
#.O...O.#...#**O*.#
#..##.O.#..##****.#
#####...######***##
    #####    #####
