############
##.....##..#
##...O...O.#
####.##.OO.#
#...O.#....#
#.OOO.#.####
#...#.#.O.##
#..#..#..O.#
#.O#.O#....#
#...**#.####
####**.O.#@#
#*****#.O#.#
##****#..O.#
###**##....#
############
