             ######
 #############****#
##...##.....##****#
#..OO##..O.@##****#
#......OO.O#..****#
#..O.##.OO.#.#.***#
#..O.##.O..#..****#
##.#####.###.##*###
##...O..O.##...*..#
#.O###..#.#####.###
#...O...#.......#
#..O.#O.O.O###..#
#.OOO#.O...#.####
#....#..OO.#
######...###
     #####
