    ############
    #..........##
    #..#.#OO.O..#
    #O.#O#..##.@#
   ##.##.#.O.#.##
   #...O.#O..#.#
   #...#.O...#.#
   ##.O.O...##.#
   #..#..##..O.#
   #....##.OO#.#
######OO...#...#
#****#..########
#*#***.##
#****...#
#****...#
#########
