           #####
          ##...##
         ##.....#
        ##..OO..#
       ##.OO..O.#
       #.O....O.#
####   #...OO.#####
#..########.##....#
#*............OOO@#
#*#.#######.##...##
#*#.#######*.#O.O##
#***********.#....#
##############..O.#
             ##..##
              ####
