####################
#.....#..#***#@....#
#.#.......****#....#
#..O..#...#****#...#
#.##O####.##****#..#
#.O...O..#..#***#..#
#.OO.#...#...#.OO..#
###..OOO#...OO..O..#
#.O..#..#....#.O#..#
#...O#..#.......O..#
#..#....#....#..#..#
####################
