####################
#@.....#...#.......#
##.###.##..####.#.##
#....#.#..OO.......#
#..#.#.#.O.#.O.##.##
#.....O.#..#OO.#...#
#..###..#......##.##
#**#*#.O.#..O.#....#
#**#*#..O.#.##.OO..#
#****##...OO..O..#.#
#*****##........#..#
####################
