#############
#...........#
#.###.OO....#
#...#.O..O..#
#..O####O######
#.O.##........#####
#..OO.O........***#
###.##.OO#.....***#
  #.##...#.....***#
  #......#.....***#
  ###@#############
    ###
