    ######
 ####....#
 #....##.#
 #.O.....#
###.####.########
#..O...O.##..***#
#...OO.OO....***#
#....O..O##..***#
##@##.##.##..***#
 ###..O..########
 #...OO..#
 #....#..#
 #########
